R     640      640
NO   ./textures/wood.xpm

SO ./textures/wood.xpm
   WE ./textures/wood.xpm
EA ./textures/eagle.xpm

S ./textures/barrel.xpm
F 50, 156, 31
C     0, 0, 0


111111111111
122200000011
122200000001
100000000011
1W0000000011
111111111111
