R 1200 1200           
NO ./textures/bluestone.xpm         
SO ./textures/redbrick.xpm    
WE ./textures/wood.xpm
EA ./textures/eagle.xpm
S ./textures/barrel.xpm
F 0, 000, 255
C     0, 0, 0 

    1111          1111111111
    1001          1000200011
    1111          1000100011
        1111111111111111111111111
        1000000000110000000000001
        1011000001110000000000001
        1001000000000000000000001
111111111011000001110000000000001
100000000011000001110111111111111
11110111111111011100000000021
11110111111111011101010010001
11000000110101011100002010001
12222222222221100000010021111
12000020W0000110101001000111
11000001110101011111011110011
11010111111101011101111010001
11011111111111111111111111111
110111111 1111
110111111 1111
1100001
1001001
1101111          111111111
1000001          111111111
1000001          111111111
1111001
1000001          111111
1000001          110001
1111111          111111
